###########
#¡        #
#####     #
    #     #
    #     ############################
    #        #O       #          ö  O#
    #  #  #  #######  #  #  #  #  ####
    #  #  #     #     #  #  #  #  #  #
    #  #  #  ####  ## ####  ####  #  #
    #  ö  #     #  #        #        #
    ##########  #  ##########  ##### #
    #                 #  #     #     #
    ##########  #######  #  #  # #####
    #           ö    O#  #  #  #    O#
    ####### ###########  #  ##########
    #        #           #     #    ö#
    # #####  #######  ####  ###### ########
    #    ¬#       O#                      E
    #######################################