                #########################
                #O          O          O#
                #                       #
      ###########    #####      #####   ###########
      #           ö  # O #  ö   # ¬ # ö           #
      #              ## ##      ## ##             #
#######O               ö          ö              O#######
#                           ö                           #
#               #########################               #
#               #                       #               #
#               #                       #               #
###   ###########                       ###########   ###
  #   #                                           #   #
  # ¡ #                                           #   #
  #####                                           ##E##



