##############
#            #
#¡           #
#            #
## #####     #
# ö #  #  ö  #
# O #  #     #########
#####  #          # ¬#
       #  O   ### #  #
       ########   #  #
              #  ##  #
              #   ö  #
              #      #
              #      #########
              #              E
              #   O         O#
              ################